; (Japanese, UTF-8)
;------------------------------------------------------------------------------
; 『MZ-IME日本語入力・基本辞書』
; "MZ-IME Japanese Input, The Basic Dictionary"
; Copyright (C) 2016 Katayama Hirofumi MZ.
; This file is public domain software (PDS).
;------------------------------------------------------------------------------
; データ行は次の形式で表す。
;
;    <変換前><TAB><品詞分類><TAB><変換後><TAB><漢字変換コスト><TAB><変換コスト>
;
; <変換前>には、変換前のひらがなを記す。<TAB>は、タブ文字を表す。
; <品詞分類>は下記のものを指定する。
;
;   名詞、形容詞、形容動詞、連体詞、副詞、接続詞、感動詞、助詞、助動詞、
;   五段動詞、一段動詞、カ変動詞、サ変動詞　のいずれか。
;
; <変換後>には、変換後の漢字かな交じりの文字列を指定する。
; <漢字変換コスト>には、ゼロ以上の整数を指定する。
; <漢字変換コスト>が小さいほどよく使われる漢字であることを表す。
; <変換コスト>には、ゼロ以上の整数を指定する。
; <変換コスト>は省略可能であり、省略した場合はゼロを意味する。
; <変換コスト>が小さいほどよく使われる変換であることを表す。
; <漢字変換コスト>は省略可能であり、省略した場合はゼロを意味する。
; <漢字変換コスト>が省略された場合、<変換後>は省略可能である。
; <変換後>が省略された場合は、<変換後>は<変換前>と同じであるとみなされる。
; <変換後>が省略された場合は、<品詞分類>は省略可能である。
; <品詞分類>が省略された場合は、<品詞分類>は名詞とみなされる。
; 動詞・形容詞・形容動詞は、<変換前>と<変換後>の両方を基本形で記述する。
;------------------------------------------------------------------------------
ああ	感動詞
あいす	五段動詞	愛す
あいする	サ変動詞	愛する
あいする	一段動詞	愛する
あいち	名詞	愛知県
あいつ	名詞	彼奴	3
あいつぐ	五段動詞	相次ぐ
あう	五段動詞	合う
あう	五段動詞	逢う
あえぐ	五段動詞	喘ぐ
あえる	一段動詞	敢える
あえる	一段動詞	韲える
あおいく	名詞	葵区
あおぐ	五段動詞	仰ぐ
あおぐ	五段動詞	扇ぐ
あおばく	名詞	青葉区
あおもり	名詞	青森
あおもり	名詞	青森県
あかさかく	名詞	赤坂区
あかす	五段動詞	明かす
あかす	五段動詞	飽かす
あかめる	一段動詞	赤める
あからめる	一段動詞	赤らめる
あがく	五段動詞	足掻く
あがめる	一段動詞	崇める
あがる	五段動詞	上がる
あきく	名詞	安芸区
あきた	名詞	秋田
あきた	名詞	秋田県
あきなう	五段動詞	商う
あきはく	名詞	秋葉区
あきらめる	一段動詞	諦める
あきる	一段動詞	飽きる
あきれる	一段動詞	呆れる
あく	五段動詞	明く
あく	五段動詞	空く
あく	五段動詞	開く
あく	五段動詞	飽く
あける	一段動詞	明ける
あける	一段動詞	開ける
あげつらう	五段動詞	論う
あげる	一段動詞	上げる
あげる	一段動詞	挙げる
あこがれる	一段動詞	憧れる
あさおく	名詞	麻生区
あさきたく	名詞	安佐北区
あさくさく	名詞	浅草区
あさひく	名詞	旭区
あさみなみく	名詞	安佐南区
あさる	五段動詞	漁る
あざける	五段動詞	嘲る
あざぶく	名詞	麻布区
あざむく	五段動詞	欺く
あざわらう	五段動詞	嘲笑う
あざわる	五段動詞	交わる
あざわる	五段動詞	糾わる
あし	名詞	脚	1
あし	名詞	足
あじわう	五段動詞	味わう
あずかる	五段動詞	預かる
あずける	一段動詞	預ける
あせる	一段動詞	褪せる
あそこ
あそばす	五段動詞	遊ばす
あそぶ	五段動詞	遊ぶ
あたい	名詞	価	1
あたい	名詞	値
あたう	五段動詞	能う
あたえる	一段動詞	与える
あたたかい	形容詞	暖かい
あたたかい	形容詞	温かい
あたたかだ	形容動詞	暖かだ
あたたかだ	形容動詞	温かだ
あたたまる	五段動詞	暖まる
あたためる	一段動詞	暖める
あたむ	五段動詞	仇む
あたる	五段動詞	当たる
あだちく	名詞	足立区
あっち
あつい	形容詞	厚い
あつい	形容詞	暑い
あつい	形容詞	熱い
あつかう	五段動詞	扱う
あつたく	名詞	熱田区
あつべつく	名詞	厚別区
あつまる	五段動詞	集まる
あつめる	一段動詞	集める
あつらえる	一段動詞	誂える
あてがう	五段動詞	宛う
あてる	一段動詞	当てる
あと	名詞	後
あと	名詞	跡	2
あなた	名詞	貴女	2
あなた	名詞	貴方	2
あなどる	五段動詞	侮る
あの	連体詞
あのかた	名詞	あの方
あのひと	名詞	あの人
あばく	五段動詞	発く
あばれる	一段動詞	暴れる
あびせる	一段動詞	浴びせる
あびる	一段動詞	浴びる
あふれる	一段動詞	溢れる
あぶない	形容詞	危ない
あぶら	名詞	油
あぶら	名詞	脂
あぶる	五段動詞	炙る
あぶる	五段動詞	焙る
あぶれる	一段動詞	溢れる
あべのく	名詞	阿倍野区
あまえる	一段動詞	甘える
あまぎる	五段動詞	天霧る
あます	五段動詞	余す
あまやかす	五段動詞	甘やかす
あまる	五段動詞	余る
あまんじる	一段動詞	甘んじる
あむ	五段動詞	編む
あやかる	五段動詞	肖る
あやしむ	五段動詞	怪しむ
あやつる	五段動詞	操る
あやぶむ	五段動詞	危ぶむ
あやまつ	五段動詞	過つ
あやまる	五段動詞	誤る
あやまる	五段動詞	謝る
あゆむ	五段動詞	歩む
あら	感動詞
あらい	形容詞	粗い
あらい	形容詞	荒い
あらいもの	名詞	洗い物
あらう	五段動詞	洗う
あらかわく	名詞	荒川区
あらがう	五段動詞	抗う
あらす	五段動詞	荒らす
あらそう	五段動詞	争う
あらたまる	五段動詞	改まる
あらためる	一段動詞	改める
あらゆる	連体詞
あらわす	五段動詞	現す
あらわす	五段動詞	著す
あらわす	五段動詞	表す
あらわす	五段動詞	顕す
あらわれる	一段動詞	現れる
あらわれる	一段動詞	表れる
あらわれる	一段動詞	顕れる
ありく	五段動詞	歩く
ある	五段動詞	在る
ある	五段動詞	有る
ある	連体詞	或る	2
あるいは	接続詞	或いは	2
あるく	五段動詞	歩く
あれ
あれる	一段動詞	荒れる
あわす	五段動詞	合わす
あわせる	一段動詞	合わせる
あわてる	一段動詞	周章てる
あわてる	一段動詞	慌てる
あわれむ	五段動詞	憐れむ
あんじる	一段動詞	案じる
あんない	名詞	案内
いいえ	感動詞
いう	五段動詞	言う
いえ	名詞	家
いえる	一段動詞	癒える
いかす	五段動詞	生かす
いからかす	五段動詞	怒らかす
いからす	五段動詞	怒らす
いかる	五段動詞	怒る
いきづく	五段動詞	息衝く
いきどおる	五段動詞	憤る
いきる	一段動詞	生きる
いきる	五段動詞	熱る
いく	五段動詞	行く
いくたく	名詞	生田区
いくのく	名詞	生野区
いける	一段動詞	生ける
いこう	五段動詞	憩う
いさかう	五段動詞	諍う
いさむ	五段動詞	勇む
いさめる	一段動詞	諫める
いざなう	五段動詞	誘う
いしかわ	名詞	石川県
いじめる	一段動詞	苛める
いずみく	名詞	泉区
いそがす	五段動詞	急がす
いそぐ	五段動詞	急ぐ
いそごく	名詞	磯子区
いたす	五段動詞	致す
いただく	五段動詞	戴く
いただく	五段動詞	頂く
いたばしく	名詞	板橋区
いたむ	五段動詞	悼む
いたむ	五段動詞	痛む
いためる	一段動詞	炒める
いためる	一段動詞	痛める
いたる	五段動詞	到る
いたる	五段動詞	至る
いたわる	五段動詞	労る
いだく	五段動詞	抱く
いだす	五段動詞	出す
いち	名詞	一
いつくしむ	五段動詞	慈しむ
いつつ	名詞	五つ
いつわる	五段動詞	偽る
いでたつ	五段動詞	出立つ
いでむかう	五段動詞	出向かう
いでる	一段動詞	出でる
いとう	五段動詞	厭う
いとなむ	五段動詞	営む
いどむ	五段動詞	挑む
いなおる	五段動詞	居直る
いなげく	名詞	稲毛区
いななく	五段動詞	嘶く
いなむ	五段動詞	否む
いぬ	五段動詞	去ぬ
いぬ	五段動詞	往ぬ
いぬ	名詞	犬
いのる	五段動詞	祈る
いばらき	名詞	茨城県
いばる	五段動詞	威張る
いふく	名詞	衣服
いぶかる	五段動詞	訝る
いましめる	一段動詞	戒める
いむ	五段動詞	忌む
いや	感動詞
いやす	五段動詞	癒す
いらう	五段動詞	弄う
いる	一段動詞	射る
いる	一段動詞	居る
いる	一段動詞	沃る
いる	一段動詞	率る
いる	一段動詞	鋳る
いる	五段動詞	入る
いる	五段動詞	煎る
いる	五段動詞	要る
いれる	一段動詞	入れる
いろづく	五段動詞	色付く
いろどる	五段動詞	彩る
いろめく	五段動詞	色めく
いわう	五段動詞	祝う
いわす	五段動詞	言わす
いわつきく	名詞	岩槻区
いわて	名詞	岩手県
う	助動詞
うえる	一段動詞	植える
うえる	一段動詞	飢える
うかがう	五段動詞	伺う
うかす	五段動詞	浮かす
うかぶ	五段動詞	浮かぶ
うかべる	一段動詞	浮かべる
うかる	五段動詞	受かる
うかれる	一段動詞	浮かれる
うがつ	五段動詞	穿つ
うきょうく	名詞	右京区
うく	五段動詞	浮く
うけとる	五段動詞	受取る
うける	一段動詞	受ける
うごかす	五段動詞	動かす
うごく	五段動詞	動く
うしごめく	名詞	牛込区
うしなう	五段動詞	失う
うすまる	五段動詞	薄まる
うすめる	一段動詞	薄める
うすらぐ	五段動詞	薄らぐ
うずく	五段動詞	疼く
うずくまる	五段動詞	蹲る
うずまく	五段動詞	渦巻く
うずまる	五段動詞	埋まる
うずむ	五段動詞	埋む
うずめる	一段動詞	埋める
うずもれる	一段動詞	埋もれる
うせる	一段動詞	失せる
うそぶく	五段動詞	嘯く
うたう	五段動詞	歌う
うたがう	五段動詞	疑う
うちあける	一段動詞	打明ける
うちいる	五段動詞	打入る
うちとる	五段動詞	討取る
うちわる	五段動詞	打割る
うったえる	一段動詞	訴える
うつ	五段動詞	打つ
うつ	五段動詞	討つ
うつくしい	形容詞	美しい
うつす	五段動詞	写す
うつす	五段動詞	移す
うつのみや	名詞	宇都宮
うつぶす	五段動詞	俯す
うつる	五段動詞	写る
うつる	五段動詞	映る
うつる	五段動詞	移る
うつろう	五段動詞	移ろう
うてる	一段動詞	打てる
うとむ	五段動詞	疎む
うとんじる	一段動詞	疎んじる
うながす	五段動詞	促す
うなずく	五段動詞	頷く
うなだれる	一段動詞	項垂れる
うなる	五段動詞	唸る
うばう	五段動詞	奪う
うべなう	五段動詞	諾う
うま	名詞	馬
うまる	五段動詞	埋まる
うまれる	一段動詞	生まれる
うまれる	一段動詞	産まれる
うむ	五段動詞	倦む
うむ	五段動詞	生む
うむ	五段動詞	産む
うむ	五段動詞	膿む
うめる	一段動詞	埋める
うめる	一段動詞	填める
うもれる	一段動詞	埋もれる
うやまう	五段動詞	敬う
うらなう	五段動詞	占う
うらむ	五段動詞	恨む
うらやむ	五段動詞	羨む
うらわく	名詞	浦和区
うる	五段動詞	売る
うるおう	五段動詞	潤う
うるおす	五段動詞	潤す
うるむ	五段動詞	潤む
うれえる	一段動詞	愁える
うれえる	一段動詞	憂える
うれる	一段動詞	売れる
うろたえる	一段動詞	狼狽える
うわる	五段動詞	植わる
ええ	感動詞
えがく	五段動詞	描く
えぐる	五段動詞	抉る
えする	一段動詞	会する
えっする	一段動詞	謁する
えどがわく	名詞	江戸川区
えどる	五段動詞	絵取る
えばらく	名詞	荏原区
えひめ	名詞	愛媛県
えむ	五段動詞	笑む
えらぶ	五段動詞	選ぶ
える	一段動詞	得る
える	五段動詞	彫る
おい	感動詞
おいうつ	五段動詞	追討つ
おいる	一段動詞	生いる
おいる	一段動詞	老いる
おう	五段動詞	負う
おう	五段動詞	追う
おうじく	名詞	王子区
おうじる	一段動詞	応じる
おえる	一段動詞	終える
おお	感動詞
おおい	形容詞	多い
おおいた	名詞	大分
おおいた	名詞	大分県
おおう	五段動詞	覆う
おおきな	連体詞	大きな
おおさか	名詞	大阪
おおさか	名詞	大阪府
おおさかし	名詞	大阪市
おおさかふ	名詞	大阪府
おおす	五段動詞	生おす
おおせる	一段動詞	仰せる
おおせる	一段動詞	果せる
おおせる	一段動詞	課せる
おおせる	一段動詞	負せる
おおたく	名詞	大田区
おおつ	名詞	大津
おおみやく	名詞	大宮区
おおもりく	名詞	大森区
おおよどく	名詞	大淀区
おかしな	連体詞	可笑しな	2
おかす	五段動詞	侵す
おかす	五段動詞	犯す
おかやま	名詞	岡山
おかやま	名詞	岡山県
おかやまし	名詞	岡山市
おがむ	五段動詞	拝む
おきなわ	名詞	沖縄県
おきる	一段動詞	起きる
おぎなう	五段動詞	補う
おく	五段動詞	措く
おく	五段動詞	置く
おく	名詞	億
おくする	一段動詞	臆する
おくらす	五段動詞	後らす
おくる	五段動詞	贈る
おくる	五段動詞	送る
おくれる	一段動詞	後れる
おくれる	一段動詞	遅れる
おこす	五段動詞	興こす
おこす	五段動詞	起こす
おこたる	五段動詞	怠る
おこなう	五段動詞	行う
おこる	五段動詞	怒る
おこる	五段動詞	起こる
おごる	五段動詞	奢る
おごる	五段動詞	驕る
おさえる	一段動詞	抑える
おさえる	一段動詞	押さえる
おさかな	名詞	お魚
おさまる	五段動詞	収まる
おさまる	五段動詞	治まる
おさめる	一段動詞	収める
おさめる	一段動詞	治める
おしえる	一段動詞	教える
おしはかる	五段動詞	推量る
おしひらく	五段動詞	押開く
おしむ	五段動詞	惜しむ
おじる	一段動詞	怖じる
おす	五段動詞	押す
おす	五段動詞	推す
おそう	五段動詞	襲う
おそなわる	五段動詞	遅なわる
おそらく	副詞	恐らく	1
おそれる	一段動詞	恐れる
おそわる	五段動詞	教わる
おだてる	一段動詞	煽てる
おちいる	五段動詞	陥る
おちつく	五段動詞	落着く
おちぶれる	一段動詞	落ちぶれる
おちゃ	名詞	お茶
おちる	一段動詞	落ちる
おとしめる	一段動詞	劣める
おとしめる	一段動詞	貶める
おとす	五段動詞	落とす
おとずれる	一段動詞	訪れる
おとなう	五段動詞	訪う
おとなう	五段動詞	音なう
おとる	五段動詞	劣る
おとろえる	一段動詞	衰える
おどす	五段動詞	威す
おどす	五段動詞	脅す
おどる	五段動詞	踊る
おどろかす	五段動詞	驚かす
おどろく	五段動詞	驚く
おのが	連体詞	己が	3
おののく	五段動詞	戦慄く
おはよう	感動詞	お早う	2
おびえる	一段動詞	怯える
おびやかす	五段動詞	脅かす
おびる	一段動詞	帯びる
おぼえる	一段動詞	覚える
おぼしめす	五段動詞	思召す
おぼす	五段動詞	思す
おぼれる	一段動詞	溺れる
おまえ	名詞	お前
おめく	五段動詞	喚く
おもいやる	五段動詞	思遣る
おもう	五段動詞	思う
おもねる	五段動詞	阿る
おもむく	五段動詞	赴く
おもる	五段動詞	重る
おもんじる	一段動詞	重んじる
おもんずる	サ変動詞	重んずる
おもんみる	一段動詞	惟る
おや	名詞	親
おや	感動詞
おゆ	名詞	お湯
およぐ	五段動詞	泳ぐ
およげる	一段動詞	泳げる
および	接続詞	及び
およぶ	五段動詞	及ぶ
おりる	一段動詞	下りる
おりる	一段動詞	降りる
おる	五段動詞	居る
おる	五段動詞	折る
おる	五段動詞	織る
おれる	一段動詞	折れる
おろす	五段動詞	下ろす
おわします	五段動詞	御座します
おわする	一段動詞	御座する
おわる	五段動詞	終わる
か	助詞
かいくる	五段動詞	掻繰る
かいはつ	名詞	開発
かいまみる	一段動詞	垣間見る
かう	五段動詞	交う
かう	五段動詞	買う
かう	五段動詞	飼う
かえす	五段動詞	帰す
かえす	五段動詞	返す
かえりみる	一段動詞	省みる
かえりみる	一段動詞	顧みる
かえる	一段動詞	代える
かえる	一段動詞	変える
かえる	一段動詞	替える
かえる	五段動詞	孵る
かえる	五段動詞	帰る
かえる	五段動詞	返る
かおる	五段動詞	薫る
かおる	五段動詞	香る
かかえる	一段動詞	抱える
かかげる	一段動詞	掲げる
かかす	五段動詞	欠かす
かかる	五段動詞	懸かる
かかる	五段動詞	掛かる
かかる	五段動詞	斯有る
かかわる	五段動詞	係わる
かかわる	五段動詞	拘わる
かかわる	五段動詞	関わる
かがく	名詞	化学
かがく	名詞	科学
かがまる	五段動詞	屈まる
かがむ	五段動詞	屈む
かがめる	一段動詞	屈める
かがやく	五段動詞	輝く
かがわ	名詞	香川県
かく	五段動詞	掻く
かく	五段動詞	描く
かく	五段動詞	書く
かく	五段動詞	欠く
かく	五段動詞	舁く
かくす	五段動詞	隠す
かくまう	五段動詞	匿う
かくれる	一段動詞	隠れる
かぐ	五段動詞	嗅ぐ
かける	一段動詞	懸ける
かける	一段動詞	掛ける
かける	一段動詞	書ける
かける	一段動詞	欠ける
かける	一段動詞	駆ける
かける	一段動詞	駈ける
かげ	名詞	影
かげ	名詞	陰
かこう	五段動詞	囲う
かこつ	五段動詞	託つ
かこむ	五段動詞	囲む
かごしま	名詞	鹿児島
かごしま	名詞	鹿児島県
かさなる	五段動詞	重なる
かさねる	一段動詞	重ねる
かさむ	五段動詞	嵩む
かざす	五段動詞	挿頭す
かざす	五段動詞	翳す
かざる	五段動詞	飾る
かしぐ	五段動詞	炊ぐ
かしこまる	五段動詞	畏まる
かしこむ	五段動詞	畏む
かしずく	五段動詞	傅く
かじる	五段動詞	囓る
かす	五段動詞	貸す
かすむ	五段動詞	霞む
かすめる	一段動詞	掠める
かする	五段動詞	掠る
かすれる	一段動詞	かすれる
かずける	一段動詞	被ける
かせぐ	五段動詞	稼ぐ
かぞえる	一段動詞	数える
かた	名詞	型
かた	名詞	形
かたい	形容詞	固い
かたい	形容詞	堅い
かたい	形容詞	硬い
かたげる	一段動詞	担げる
かたづく	五段動詞	片付く
かたづける	一段動詞	片付ける
かたどる	五段動詞	象る
かたまる	五段動詞	固まる
かたむく	五段動詞	傾く
かたむける	一段動詞	傾ける
かためる	一段動詞	固める
かたらう	五段動詞	語らう
かたる	五段動詞	語る
かつ	五段動詞	勝つ
かつぐ	五段動詞	担ぐ
かつぐ	五段動詞	被ぐ
かつしかく	名詞	葛飾区
かつよう	名詞	活用
かなう	五段動詞	叶う
かなえる	一段動詞	叶える
かながわ	名詞	神奈川県
かながわく	名詞	神奈川区
かなぐる	五段動詞	かなぐる
かなざわ	名詞	金沢
かなざわく	名詞	金沢区
かなしむ	五段動詞	悲しむ
かなでる	一段動詞	奏でる
かね	名詞	金
かねる	一段動詞	兼ねる
かばう	五段動詞	庇う
かびる	一段動詞	黴びる
かぶさる	五段動詞	被さる
かぶせる	一段動詞	被せる
かぶる	五段動詞	冠る
かぶる	五段動詞	被る
かぶれる	一段動詞	かぶれる
かまう	五段動詞	構う
かまえる	一段動詞	構える
かまたく	名詞	蒲田区
かみぎょうく	名詞	上京区
かむ	五段動詞	かむ
かむ	五段動詞	噛む
かよう	五段動詞	通う
かよわす	五段動詞	通わす
から	助詞
からげる	一段動詞	絡げる
からす	五段動詞	枯らす
からす	五段動詞	涸らす
からだ	名詞	体
からだ	名詞	身体
からまる	五段動詞	絡まる
からむ	五段動詞	溺む
からむ	五段動詞	絡む
からめる	一段動詞	溺める
からめる	一段動詞	絡める
かりる	一段動詞	借りる
かる	五段動詞	借る
かる	五段動詞	刈る
かる	五段動詞	狩る
かる	五段動詞	苅る
かる	五段動詞	駆る
かる	五段動詞	駈る
かれる	一段動詞	枯れる
かれる	一段動詞	涸れる
かろんじる	一段動詞	軽んじる
かわ	名詞	川
かわ	名詞	皮
かわ	名詞	革
かわく	五段動詞	乾く
かわさきく	名詞	川崎区
かわす	五段動詞	交わす
かわる	五段動詞	代わる
かわる	五段動詞	変わる
かわる	五段動詞	替わる
かんがえる	一段動詞	考える
かんがみる	一段動詞	鑑みる
かんじ	名詞	漢字
かんじる	一段動詞	感じる
かんだく	名詞	神田区
が	助詞
がいする	一段動詞	害する
がくせい	名詞	学生
がっこう	名詞	学校
がっする	一段動詞	合する
き	名詞	木
きえる	一段動詞	消える
きかい	名詞	器械
きかい	名詞	機会
きかい	名詞	機械
きかす	五段動詞	聞かす
きかせる	一段動詞	聞かせる
きがえる	一段動詞	着替える
きく	五段動詞	利く
きく	五段動詞	効く
きく	五段動詞	聞く
きこえる	一段動詞	聞こえる
きこす	五段動詞	聞こす
きごう	名詞	記号
きざす	五段動詞	兆す
きざす	五段動詞	萌す
きざむ	五段動詞	刻む
きしる	五段動詞	軋る
きすぎる	一段動詞	来すぎる
きすぎる	一段動詞	着すぎる
きする	一段動詞	帰する
きする	一段動詞	記する
きずく	五段動詞	築く
きせる	一段動詞	着せる
きそう	五段動詞	競う
きたえる	一段動詞	鍛える
きたきゅうしゅうし	名詞	北九州市
きたく	名詞	北区
きたす	五段動詞	来す
きたる	五段動詞	来る
きっと	副詞
きつね	名詞	狐	2
きづく	五段動詞	気づく
きどる	五段動詞	気取る
きばむ	五段動詞	黄ばむ
きばる	五段動詞	気張る
きまる	五段動詞	決まる
きみ	名詞	君
きみ	名詞	黄身
きめる	一段動詞	決める
きゅう	名詞	九
きょうだい	名詞	兄妹
きょうだい	名詞	兄弟
きょうだい	名詞	姉妹
きょうだい	名詞	姉弟
きょうと	名詞	京都
きょうと	名詞	京都府
きょうとし	名詞	京都市
きょうとふ	名詞	京都府
きようばしく	名詞	京橋区
きよたく	名詞	清田区
きよまる	五段動詞	清まる
きよめる	一段動詞	浄める
きよめる	一段動詞	清める
きらう	五段動詞	嫌う
きらす	五段動詞	切らす
きる	一段動詞	着る
きる	五段動詞	切る
きる	五段動詞	斬る
きれる	一段動詞	切れる
きわまる	五段動詞	極まる
きわまる	五段動詞	窮まる
きわめる	一段動詞	極める
きわめる	一段動詞	窮める
きんじる	一段動詞	禁じる
きんずる	一段動詞	禁ずる
ぎふ	名詞	岐阜
ぎふ	名詞	岐阜県
くいしばる	五段動詞	食縛る
くいる	一段動詞	悔いる
くう	五段動詞	食う
くぎる	五段動詞	区切る
くくむ	五段動詞	含む
くくむ	五段動詞	銜む
くくる	五段動詞	括る
くぐもる	五段動詞	含もる
くぐる	五段動詞	潜る
くさる	五段動詞	腐る
くじく	五段動詞	挫く
くじける	一段動詞	挫ける
くじる	五段動詞	抉る
くずす	五段動詞	崩す
くずれる	一段動詞	崩れる
くたす	五段動詞	朽たす
くたす	五段動詞	腐たす
くだく	五段動詞	砕く
くだける	一段動詞	砕ける
くださる	五段動詞	下さる
くだす	五段動詞	下す
くだす	五段動詞	降す
くだものやさん	名詞	果物屋さん
くだる	五段動詞	下る
くだる	五段動詞	降る
くちる	一段動詞	朽ちる
くつがえす	五段動詞	覆す
くつがえる	五段動詞	覆る
くどく	五段動詞	口説く
くねる	五段動詞	拗る
くねる	五段動詞	曲る
くばる	五段動詞	配る
くびれる	一段動詞	縊れる
くべる	一段動詞	焼べる
くべる	一段動詞	燻べる
くぼむ	五段動詞	窪む
くまもと	名詞	熊本
くまもと	名詞	熊本県
くまもとし	名詞	熊本市
くみする	一段動詞	組する
くむ	五段動詞	汲む
くむ	五段動詞	組む
くむ	五段動詞	酌む
くもる	五段動詞	曇る
くやしむ	五段動詞	悔しむ
くやむ	五段動詞	悔やむ
くゆる	五段動詞	燻る
くら	名詞	倉
くら	名詞	蔵
くらい	助詞	位	1
くらう	五段動詞	喰らう
くらう	五段動詞	食らう
くらす	五段動詞	暮らす
くらべる	一段動詞	比べる
くらべる	一段動詞	競べる
くらます	五段動詞	眩ます
くらむ	五段動詞	眩む
くる	カ変動詞	来る
くる	一段動詞	来る
くる	五段動詞	繰る
くるう	五段動詞	狂う
くるしむ	五段動詞	苦しむ
くるしめる	一段動詞	苦しめる
くれる	一段動詞	呉れる
くれる	一段動詞	暗れる
くれる	一段動詞	暮れる
くれる	一段動詞	眩れる
くろむ	五段動詞	黒む
くわえる	一段動詞	加える
くわえる	一段動詞	咥える
くわえる	一段動詞	銜える
くわだてる	一段動詞	企てる
くわわる	五段動詞	加わる
ぐらい	助詞	位	1
ぐれる	一段動詞	ぐれる
ぐんぐん	副詞
ぐんま	名詞	群馬県
けいさん	名詞	計算
けいさんき	名詞	計算機
けがす	五段動詞	汚す
けがす	五段動詞	穢す
けがれる	一段動詞	汚れる
けがれる	一段動詞	穢れる
けす	五段動詞	消す
けずる	五段動詞	削る
けっして	副詞	決して
けつかる	五段動詞	けつかる
けなす	五段動詞	貶す
けむる	五段動詞	煙る
ける	五段動詞	蹴る
けれど	助詞
けれど	接続詞
けれども	接続詞
けんきゅう	名詞	研究
けんじる	一段動詞	献じる
こいしかわく	名詞	小石川区
こいつ	名詞	此奴	3
こいねがう	五段動詞	乞願う
こいる	一段動詞	恋いる
こう	五段動詞	乞う
こう	五段動詞	請う
こうこう	名詞	高校
こうこうせい	名詞	高校生
こうさく	名詞	工作
こうじまちく	名詞	麹町区
こうち	名詞	高知
こうち	名詞	高知県
こうとうく	名詞	江東区
こうなんく	名詞	江南区
こうなんく	名詞	港南区
こうふ	名詞	甲府
こうべ	名詞	神戸
こうべく	名詞	神戸区
こうべし	名詞	神戸市
こうほくく	名詞	港北区
こうむる	五段動詞	被る
こえる	一段動詞	肥える
こえる	一段動詞	越える
こおり	名詞	氷
こおる	五段動詞	凍る
こおる	五段動詞	氷る
こかす	五段動詞	転かす
こがす	五段動詞	焦がす
こがれる	一段動詞	焦がれる
こく	五段動詞	扱く
こく	五段動詞	放く
こくらきたく	名詞	小倉北区
こくらく	名詞	小倉区
こくらみなみく	名詞	小倉南区
こぐ	五段動詞	漕ぐ
こける	一段動詞	転ける
こげる	一段動詞	焦げる
ここ	名詞	此処	3
ここのつ	名詞	九つ
こころえる	一段動詞	心得る
こころみる	一段動詞	試みる
こごる	五段動詞	凝る
こざかな	名詞	小魚
こしらえる	一段動詞	拵える
こじる	一段動詞	掘じる
こじる	五段動詞	抉る
こじれる	一段動詞	こじれる
こす	五段動詞	越す
こする	五段動詞	擦る
こそ	助詞
こぞる	五段動詞	拳る
こたえる	一段動詞	堪える
こたえる	一段動詞	応える
こたえる	一段動詞	答える
こっち
こづく	五段動詞	小突く
こと	助詞
こと
ことなる	五段動詞	異なる
ことば	名詞	言葉
ことわる	五段動詞	断る
こなす	五段動詞	熟す
こねる	一段動詞	こねる
この	連体詞	此の	3
このかた	名詞	この方
このはなく	名詞	此花区
このひと	名詞	この人
このむ	五段動詞	好む
こばむ	五段動詞	拒む
こびる	一段動詞	媚びる
こぼす	五段動詞	零す
こぼれる	一段動詞	壊れる
こぼれる	一段動詞	毀れる
こぼれる	一段動詞	零れる
こまかい	形容詞	細かい
こまかだ	形容動詞	細かだ
こまぬく	五段動詞	拱く
こまる	五段動詞	困る
こむ	五段動詞	込む
こめる	一段動詞	籠める
こめる	一段動詞	込める
こもる	五段動詞	籠もる
こやす	五段動詞	肥やす
こらえる	一段動詞	堪える
こらす	五段動詞	凝らす
こらす	五段動詞	懲らす
こりる	一段動詞	懲りる
こる	五段動詞	伐る
こる	五段動詞	凝る
こる	五段動詞	樵る
これ	名詞	之	3
これ	名詞	是	3
これ	名詞	此れ	3
ころす	五段動詞	殺す
ころぶ	五段動詞	転ぶ
こわれる	一段動詞	壊れる
こんにちは	感動詞	今日は	2
こんにちわ	感動詞
ご	名詞	五
ごあんない	名詞	ご案内
ごする	一段動詞	期する
ごりよう	名詞	ご利用
ごろうじる	一段動詞	御覧じる
さ	助詞
さあ	感動詞
さいたま	名詞	埼玉県
さいたまし	名詞	さいたま市
さいなむ	五段動詞	苛む
さいなん	名詞	災難
さいわいく	名詞	幸区
さえ	助詞
さえきく	名詞	佐伯区
さえずる	五段動詞	囀る
さえる	一段動詞	冴える
さかいく	名詞	堺区
さかいし	名詞	堺市
さかえく	名詞	栄区
さかえる	一段動詞	栄える
さかな	名詞	魚
さかなやさん	名詞	魚屋さん
さかのぼる	五段動詞	遡る
さかや	名詞	酒屋
さからう	五段動詞	逆らう
さが	名詞	佐賀
さが	名詞	佐賀県
さがす	五段動詞	捜す
さがみはらし	名詞	相模原市
さがる	五段動詞	下がる
さきだつ	五段動詞	先立つ
さきょうく	名詞	左京区
さく	五段動詞	割く
さく	五段動詞	咲く
さく	五段動詞	裂く
さくらく	名詞	桜区
さぐる	五段動詞	探る
さけぶ	五段動詞	叫ぶ
さける	一段動詞	裂ける
さげる	一段動詞	下げる
さげる	一段動詞	提げる
ささえる	一段動詞	支える
ささげる	一段動詞	捧げる
ささやく	五段動詞	囁く
ささる	五段動詞	刺さる
さざめく	五段動詞	さざめく
さしおく	五段動詞	差置く
さしはさむ	五段動詞	差挟む
さす	五段動詞	刺す
さす	五段動詞	差す
さす	五段動詞	指す
さす	五段動詞	鎖す
さすらう	五段動詞	流離う
さする	五段動詞	さする
さずかる	五段動詞	授かる
さずける	一段動詞	授ける
させ	助動詞
させよ	助動詞
させる	助動詞
させれ	助動詞
させろ	助動詞
さそう	五段動詞	誘う
さぞ	副詞
さだまる	五段動詞	定まる
さだめる	一段動詞	定める
さっする	一段動詞	察する
さっぽろ	名詞	札幌
さっぽろし	名詞	札幌市
さて	接続詞
さとす	五段動詞	諭す
さとる	五段動詞	悟る
さとる	五段動詞	覚る
さばく	五段動詞	裁く
さびる	一段動詞	荒びる
さびる	一段動詞	錆びる
さぶらう	五段動詞	侍う
さぶらう	五段動詞	候う
さます	五段動詞	覚ます
さまたげる	一段動詞	妨げる
さまよう	五段動詞	彷徨う
さめる	一段動詞	覚める
さめる	一段動詞	醒める
さよう	名詞	作用
さらう	五段動詞	攫う
さらえる	一段動詞	掠える
さらえる	一段動詞	攫える
さらえる	一段動詞	浚える
さらす	五段動詞	晒す
さる	五段動詞	去る
さる	連体詞	然る	3
さわぐ	五段動詞	騒ぐ
さわらく	名詞	早良区
さわる	五段動詞	触る
さわる	五段動詞	障る
さん	名詞	三
さんじる	一段動詞	参じる
さんじる	一段動詞	散じる
さんすう	名詞	算数
ざする	一段動詞	坐する
ざする	一段動詞	座する
し	助詞
し	名詞	四
し	名詞	死
しあげる	一段動詞	仕上げる
しいだす	五段動詞	為出だす
しいる	一段動詞	強いる
しいれる	一段動詞	仕入れる
しおく	五段動詞	為置く
しおたれる	一段動詞	潮垂れる
しおれる	一段動詞	萎れる
しか	助詞
しかける	一段動詞	仕掛ける
しかし	接続詞	併し	3
しかし	接続詞	然し	3
しかめる	一段動詞	顰める
しかる	五段動詞	叱る
しかる	五段動詞	然る
しが	名詞	滋賀県
しきいる	一段動詞	敷居る
しきる	五段動詞	仕切る
しく	五段動詞	及く
しく	五段動詞	如く
しく	五段動詞	敷く
しくむ	五段動詞	仕組む
しぐらう	五段動詞	時雨らう
しこむ	五段動詞	仕込む
しする	一段動詞	死する
しずおか	名詞	静岡
しずおか	名詞	静岡県
しずおかし	名詞	静岡市
しずまる	五段動詞	静まる
しずむ	五段動詞	沈む
しずめる	一段動詞	沈める
しずめる	一段動詞	鎮める
しずめる	一段動詞	静める
しそんじる	一段動詞	仕損じる
したう	五段動詞	慕う
したがう	五段動詞	従う
したがえる	一段動詞	従える
したためる	一段動詞	認める
したたる	五段動詞	滴る
したてる	一段動詞	仕立てる
したやく	名詞	下谷区
しだす	五段動詞	し出す
しだれる	一段動詞	垂れる
しち	名詞	七
しっする	一段動詞	執する
しっする	一段動詞	失する
しつける	一段動詞	躾る
しつない	名詞	室内
しつらう	五段動詞	しつらう
しながわく	名詞	品川区
しなびる	一段動詞	萎びる
しなもの	名詞	品物
しぬ	五段動詞	死ぬ
しのぐ	五段動詞	凌ぐ
しのびる	一段動詞	忍びる
しのぶ	五段動詞	偲ぶ
しのぶ	五段動詞	忍ぶ
しのぶ	五段動詞	悲ぶ
しばく	名詞	芝区
しばらく	副詞
しばる	五段動詞	縛る
しびれる	一段動詞	痺れる
しぶやく	名詞	渋谷区
しぶる	五段動詞	渋る
しぼむ	五段動詞	凋む
しぼむ	五段動詞	萎む
しぼる	五段動詞	絞る
しまう	五段動詞	仕舞う
しまね	名詞	島根県
しまる	五段動詞	締まる
しまる	五段動詞	閉まる
しみずく	名詞	清水区
しみる	一段動詞	凍みる
しむ	五段動詞	染む
しむける	一段動詞	仕向ける
しめす	五段動詞	示す
しめる	一段動詞	占める
しめる	一段動詞	締める
しめる	五段動詞	湿る
しもぎょうく	名詞	下京区
しゃかい	名詞	社会
しゃがむ	五段動詞	しゃがむ
しゃくする	一段動詞	釈する
しゃする	一段動詞	謝する
しゅくする	一段動詞	宿する
しゅする	一段動詞	修する
しょうがくせい	名詞	小学生
しょうがっこう	名詞	小学校
しょうぎょう	名詞	商業
しょうじる	一段動詞	生じる
しょうじる	一段動詞	請じる
しょうする	一段動詞	消する
しょうする	一段動詞	賞する
しょうわく	名詞	昭和区
しょくする	一段動詞	属する
しらける	一段動詞	白ける
しらげる	一段動詞	精げる
しらす	五段動詞	知らす
しらせる	一段動詞	知らせる
しらべる	一段動詞	調べる
しらむ	五段動詞	白む
しりぞく	五段動詞	退く
しりぞける	一段動詞	退ける
しる	五段動詞	知る
しるす	五段動詞	記す
しれる	一段動詞	知れる
しろいしく	名詞	白石区
しわぶく	五段動詞	咳く
しわむ	五段動詞	皺む
しんじゅくく	名詞	新宿区
しんじる	一段動詞	信じる
しんじる	一段動詞	進じる
じかん	名詞	時間
じけん	名詞	事件
じしょ	名詞	辞書
じする	一段動詞	持する
じする	一段動詞	治する
じする	一段動詞	辞する
じてん	名詞	辞典
じめん	名詞	地面
じゃらす	五段動詞	戯らす
じゃれる	一段動詞	戯れる
じゅう	名詞	十
じゅうする	一段動詞	住する
じゅじる	一段動詞	誦じる
じょうじる	一段動詞	乗じる
じょうとうく	名詞	城東区
じょうなんく	名詞	城南区
じらす	五段動詞	焦らす
じんどる	五段動詞	陣取る
すいめん	名詞	水面
すう	五段動詞	吸う
すうがく	名詞	数学
すえる	一段動詞	据える
すかす	五段動詞	賺す
すかす	五段動詞	透かす
すがる	五段動詞	縋る
すぎなみく	名詞	杉並区
すぎる	一段動詞	過ぎる
すく	五段動詞	梳く
すく	五段動詞	透く
すく	五段動詞	鍬く
すくう	五段動詞	巣くう
すくう	五段動詞	掬う
すくう	五段動詞	救う
すくむ	五段動詞	竦む
すぐ	副詞
すぐる	五段動詞	選る
すぐれる	一段動詞	優れる
すぐれる	一段動詞	勝れる
すける	一段動詞	助ける
すける	一段動詞	透ける
すごす	五段動詞	過ごす
すすぐ	五段動詞	濯ぐ
すすむ	五段動詞	進む
すすめる	一段動詞	勧める
すすめる	一段動詞	進める
すする	五段動詞	啜る
すずむ	五段動詞	涼む
すたる	五段動詞	廃る
すたれる	一段動詞	廃れる
すだく	五段動詞	集く
すてる	一段動詞	捨てる
すねる	一段動詞	拗ねる
すべらす	五段動詞	滑らす
すべる	一段動詞	統べる
すべる	五段動詞	滑る
すぼまる	五段動詞	窄まる
すぼめる	一段動詞	窄める
すまう	五段動詞	住まう
すまく	名詞	須磨区
すます	五段動詞	洗ます
すます	五段動詞	済ます
すます	五段動詞	澄ます
すみだく	名詞	墨田区
すみのえく	名詞	住之江区
すみよしく	名詞	住吉区
すむ	五段動詞	住む
すむ	五段動詞	清む
すむ	五段動詞	済む
すむ	五段動詞	澄む
する	サ変動詞	する
する	一段動詞	為る
する	五段動詞	磨る
するがく	名詞	駿河区
すると	接続詞
すれる	一段動詞	擦れる
すれる	一段動詞	磨れる
すわる	五段動詞	座る
ず	助動詞
ずこう	名詞	図工
ずっと	副詞
ずつ	助詞
ずぬける	一段動詞	図抜ける
ずらす	五段動詞	ずらす
ずる	五段動詞	ずる
ずれる	一段動詞	ずれる
せ	助動詞
せいしゅん	名詞	青春
せいする	一段動詞	制する
せいする	一段動詞	製する
せおう	五段動詞	背負う
せかいし	名詞	世界史
せかす	五段動詞	急かす
せかせる	一段動詞	急かせる
せがむ	五段動詞	せがむ
せく	五段動詞	咳く
せく	五段動詞	堰く
せく	五段動詞	塞く
せく	五段動詞	急く
せたがやく	名詞	世田谷区
せっする	一段動詞	接する
せばまる	五段動詞	狭まる
せばめる	一段動詞	狭める
せまる	五段動詞	迫る
せめぐ	五段動詞	鬩ぐ
せめる	一段動詞	攻める
せめる	一段動詞	責める
せやく	名詞	瀬谷区
せよ	助動詞
せる	五段動詞	迫る
せる	助動詞
せれ	助動詞
せろ	助動詞
せん	名詞	千
せんじる	一段動詞	煎じる
せんじる	一段動詞	詮じる
せんだい	名詞	仙台
せんだいし	名詞	仙台市
せんろ	名詞	線路
ぜ	助詞
ぜひ	副詞	是非	1
ぜんぜん	副詞	全然
そいつ
そう	五段動詞	添う
そう	感動詞
そうさいく	名詞	湊西区
そうする	一段動詞	奏する
そうする	一段動詞	相する
そうだ	助動詞
そうだっ	助動詞
そうだろ	助動詞
そうで	助動詞
そうとうく	名詞	湊東区
そうな	助動詞
そうなら	助動詞
そうに	助動詞
そうらう	五段動詞	候う
そえる	一段動詞	添える
そぐ	五段動詞	削ぐ
そぐ	五段動詞	殺ぐ
そこ	名詞	其処	3
そこなう	五段動詞	害なう
そこなう	五段動詞	損なう
そして	接続詞
そしる	五段動詞	謗る
そそぐ	五段動詞	注ぐ
そだつ	五段動詞	育つ
そだてる	一段動詞	育てる
そっち
そなえる	一段動詞	供える
そなえる	一段動詞	備える
そなえる	一段動詞	具える
そなわる	五段動詞	備わる
そなわる	五段動詞	具わる
そねむ	五段動詞	嫉む
その	連体詞	其の	3
そのかた	名詞	その方
そのひと	名詞	その人
そばだつ	五段動詞	峙つ
そばめる	一段動詞	側める
そびれる	一段動詞	そびれる
そぼつ	五段動詞	濡つ
そまる	五段動詞	染まる
そむ	五段動詞	染む
そむく	五段動詞	背く
そむける	一段動詞	背ける
そめる	一段動詞	初める
そめる	一段動詞	染める
そよぐ	五段動詞	戦ぐ
そよめく	五段動詞	戦めく
そらす	五段動詞	反らす
そらす	五段動詞	逸らす
そる	五段動詞	剃る
そる	五段動詞	反る
それ	名詞	其れ	3
それで	接続詞	其れで	3
それとも	接続詞	其れとも	3
そろう	五段動詞	揃う
そろえる	一段動詞	揃える
そんじる	一段動詞	損じる
ぞ	助詞
ぞうする	一段動詞	造する
ぞくす	五段動詞	属す
ぞくする	サ変動詞	属する
ぞんじる	一段動詞	存じる
た	助動詞
た	名詞	田
たい	助動詞
たいいく	名詞	体育
たいいくかん	名詞	体育館
たいした	連体詞	大した	1
たいしょうく	名詞	大正区
たいする	一段動詞	帯する
たいとうく	名詞	台東区
たいはくく	名詞	太白区
たいらげる	一段動詞	平らげる
たえる	一段動詞	堪える
たえる	一段動詞	絶える
たえる	一段動詞	耐える
たおす	五段動詞	倒す
たおる	五段動詞	手折る
たおれる	一段動詞	倒れる
たかっ	助動詞
たかつく	名詞	高津区
たかまつ	名詞	高松
たかる	五段動詞	集る
たかろ	助動詞
たがう	五段動詞	違う
たがえる	一段動詞	違える
たがっ	助動詞
たがやす	五段動詞	耕す
たがら	助動詞
たがり	助動詞
たがる	助動詞
たがれ	助動詞
たがろ	助動詞
たきのがわく	名詞	瀧野川区
たく	五段動詞	焚く
たく	五段動詞	焼く
たく	助動詞
たくす	五段動詞	託す
たくする	サ変動詞	託する
たくむ	五段動詞	巧む
たくわえる	一段動詞	蓄える
たくわえる	一段動詞	貯える
たぐう	五段動詞	比う
たぐう	五段動詞	類う
たぐる	五段動詞	手繰る
たける	一段動詞	長ける
たける	一段動詞	闌ける
たけれ	助動詞
たしなむ	五段動詞	嗜む
たしなめる	一段動詞	困める
たしなめる	一段動詞	窘める
たす	五段動詞	足す
たすかる	五段動詞	助かる
たすける	一段動詞	助ける
たずさえる	一段動詞	携える
たずさわる	五段動詞	携わる
たずねる	一段動詞	尋ねる
たたえる	一段動詞	湛える
たたかう	五段動詞	戦う
たたく	五段動詞	叩く
たたす	五段動詞	立たす
たたずむ	五段動詞	佇む
たたずむ	五段動詞	彳む
たたむ	五段動詞	畳む
たたる	五段動詞	祟る
ただし	接続詞	但し	2
ただしい	形容詞	正しい
ただす	五段動詞	正す
ただなおる	五段動詞	直直る
ただよう	五段動詞	漂う
ただれる	一段動詞	爛れる
たちよる	五段動詞	立寄る
たった	連体詞
たっとぶ	五段動詞	尊ぶ
たつ	五段動詞	建つ
たつ	五段動詞	断つ
たつ	五段動詞	立つ
たつ	五段動詞	絶つ
たつ	五段動詞	裁つ
たづくる	五段動詞	田作る
たてまつる	五段動詞	奉る
たてる	一段動詞	建てる
たてる	一段動詞	立てる
たとえ	副詞	例え	2
たとえば	接続詞	例えば
たとえる	一段動詞	喩える
たとえる	一段動詞	譬える
たどる	五段動詞	辿る
たなびく	五段動詞	棚引く
たぬき	名詞	狸	2
たのしむ	五段動詞	楽しむ
たのむ	五段動詞	恃む
たのむ	五段動詞	頼む
たばかる	五段動詞	謀る
たばこ	名詞	煙草
たばねる	一段動詞	束ねる
たぶ	五段動詞	賜ぶ
たぶらかす	五段動詞	誑かす
たぶん	副詞	多分	1
たべる	一段動詞	食べる
たま	名詞	弾
たま	名詞	玉
たま	名詞	球	1
たまう	五段動詞	給う
たまう	五段動詞	賜う
たまく	名詞	多摩区
たまに	副詞
たまる	五段動詞	溜まる
たまわる	五段動詞	賜る
たむける	一段動詞	手向ける
ため
ためす	五段動詞	試す
ためらう	五段動詞	ためらう
ためる	一段動詞	揉める
ためる	一段動詞	溜める
ためる	一段動詞	矯める
たもくてき	名詞	多目的
たもつ	五段動詞	保つ
たやす	五段動詞	絶やす
たゆむ	五段動詞	弛む
たよる	五段動詞	頼る
たら	助動詞
たらす	五段動詞	垂らす
たらす	五段動詞	誑す
たり	助詞
たる	五段動詞	垂る
たる	五段動詞	足る
たるみく	名詞	垂水区
たれる	一段動詞	垂れる
たろ	助動詞
たわける	一段動詞	戯ける
たわむ	五段動詞	撓む
たわむれる	一段動詞	戯れる
だ	助動詞
だいがく	名詞	大学
だいがくせい	名詞	大学生
だから	接続詞
だが	接続詞
だく	五段動詞	抱く
だけ	助詞
だす	五段動詞	出す
だっ	助動詞
だます	五段動詞	騙す
だまる	五段動詞	黙る
だり	助詞
だろ	助動詞
ちいさな	連体詞	小さな
ちかう	五段動詞	誓う
ちかづく	五段動詞	近付く
ちがう	五段動詞	違う
ちがえる	一段動詞	違える
ちぎる	五段動詞	契る
ちくさく	名詞	千種区
ちぢまる	五段動詞	縮まる
ちぢむ	五段動詞	縮む
ちぢめる	一段動詞	縮める
ちぢれる	一段動詞	縮れる
ちなむ	五段動詞	因む
ちば	名詞	千葉
ちば	名詞	千葉県
ちばし	名詞	千葉市
ちほう	名詞	地方
ちゅうおうく	名詞	中央区
ちゅうがくせい	名詞	中学生
ちゅうがっこう	名詞	中学校
ちゅうする	一段動詞	誅する
ちゅうもん	名詞	注文
ちょう	名詞	兆
ちょうじる	一段動詞	長じる
ちょうど	副詞	丁度	2
ちよだく	名詞	千代田区
ちらす	五段動詞	散らす
ちりばめる	一段動詞	鏤める
ちる	五段動詞	散る
ちんじる	一段動詞	陣じる
つ	名詞	津
ついえる	一段動詞	弊える
ついえる	一段動詞	費える
ついばむ	五段動詞	啄む
ついやす	五段動詞	費やす
つうじる	一段動詞	通じる
つかう	五段動詞	使う
つかえる	一段動詞	仕える
つかえる	一段動詞	使える
つかさどる	五段動詞	司る
つかす	五段動詞	尽かす
つかねる	一段動詞	束ねる
つかまつる	五段動詞	仕る
つかむ	五段動詞	掴む
つかる	五段動詞	漬かる
つかれる	一段動詞	疲れる
つかわす	五段動詞	遣わす
つがう	五段動詞	番う
つがえる	一段動詞	番える
つきする	一段動詞	尽きする
つきでる	一段動詞	突き出る
つきる	一段動詞	尽きる
つく	五段動詞	付く
つく	五段動詞	吐く
つく	五段動詞	嘔く
つく	五段動詞	搗く
つく	五段動詞	撞く
つく	五段動詞	漬く
つく	五段動詞	着く
つく	五段動詞	突く
つく	五段動詞	筑く
つく	五段動詞	衝く
つくす	五段動詞	尽くす
つくばう	五段動詞	蹲う
つくる	五段動詞	作る
つくろう	五段動詞	繕う
つぐ	五段動詞	継ぐ
つぐなう	五段動詞	償う
つぐむ	五段動詞	噤む
つける	一段動詞	付ける
つける	一段動詞	漬ける
つげる	一段動詞	告げる
つたう	五段動詞	伝う
つたえる	一段動詞	伝える
つたわる	五段動詞	伝わる
つちかう	五段動詞	培う
つつしむ	五段動詞	慎む
つつむ	五段動詞	包む
つづきく	名詞	都筑区
つづく	五段動詞	続く
つづける	一段動詞	続ける
つづまる	五段動詞	約まる
つづめる	一段動詞	縮める
つづる	五段動詞	綴る
つとまる	五段動詞	勤まる
つとめる	一段動詞	勤める
つどう	五段動詞	集う
つどえる	一段動詞	集える
つなぐ	五段動詞	繋ぐ
つなげる	一段動詞	繋げる
つのる	五段動詞	募る
つぶす	五段動詞	潰す
つぶやく	五段動詞	呟く
つぶれる	一段動詞	潰れる
つぶれる	一段動詞	禿れる
つまだつ	五段動詞	爪立つ
つまづく	五段動詞	躓く
つまる	五段動詞	詰まる
つむ	五段動詞	摘む
つむ	五段動詞	積む
つむぐ	五段動詞	紡ぐ
つめる	一段動詞	詰める
つもる	五段動詞	積もる
つらなる	五段動詞	連なる
つらぬく	五段動詞	貫く
つらねる	一段動詞	連ねる
つらら	名詞	氷柱	2
つる	五段動詞	攣る
つる	五段動詞	釣る
つるす	五段動詞	吊す
つるみく	名詞	鶴見区
つるむ	五段動詞	婚む
つれる	一段動詞	連れる
つれる	一段動詞	釣れる
つんざく	五段動詞	劈く
て	助詞
ていえん	名詞	庭園
ていねく	名詞	手稲区
ておう	五段動詞	手負う
てがける	一段動詞	手掛ける
てぎわ	名詞	手際
てっする	一段動詞	徹する
てならう	五段動詞	手習う
ても	助詞
てらう	五段動詞	衒う
てらす	五段動詞	照らす
てる	五段動詞	照る
てんじる	一段動詞	転じる
てんのうじく	名詞	天王寺区
てんぱくく	名詞	天白区
てんぷら	名詞	天ぷら
てんりゅうく	名詞	天竜区
で	助動詞
で	助詞
であう	五段動詞	出会う
でかける	一段動詞	出掛ける
でかす	五段動詞	出来す
できる	一段動詞	出来る
でしょ	助動詞
でしょう	助動詞
です	助動詞
ですぎる	一段動詞	出過ぎる
では	接続詞
でも	助詞
でも	接続詞
でる	一段動詞	出る
と	助詞
とう	五段動詞	問う
とうきょう	名詞	東京
とうきょう	名詞	東京都
とうきょうと	名詞	東京都
とうぜん	副詞	当然
とうとぶ	五段動詞	尊ぶ
とお	名詞	十
とおす	五段動詞	通す
とおらす	五段動詞	通らす
とおり	名詞	通り
とおる	五段動詞	透る
とおる	五段動詞	通る
とかす	五段動詞	解かす
とがめる	一段動詞	咎める
とがる	五段動詞	尖る
とき
ときに	接続詞	時に	1
ときめく	五段動詞	ときめく
とく	五段動詞	溶く
とく	五段動詞	解く
とく	五段動詞	説く
とくしま	名詞	徳島
とくしま	名詞	徳島県
とぐ	五段動詞	研ぐ
とける	一段動詞	溶ける
とける	一段動詞	解ける
とげる	一段動詞	遂げる
ところで	助詞
ところで	接続詞	所で	3
とざす	五段動詞	閉ざす
としまく	名詞	豊島区
とじる	一段動詞	閉じる
とちぎ	名詞	栃木県
とっとり	名詞	鳥取
とっとり	名詞	鳥取県
とつかく	名詞	戸塚区
とつぐ	五段動詞	嫁ぐ
とても	副詞
ととのう	五段動詞	整う
ととのえる	一段動詞	整える
とどく	五段動詞	届く
とどける	一段動詞	届ける
とどこおる	五段動詞	滞る
とどまる	五段動詞	停まる
とどまる	五段動詞	止まる
とどまる	五段動詞	留まる
とどめる	一段動詞	停める
とどめる	一段動詞	止める
とどめる	一段動詞	留める
とどろかす	五段動詞	轟かす
とどろく	五段動詞	轟く
となえる	一段動詞	唱える
となる	五段動詞	隣る
とばす	五段動詞	飛ばす
とばたく	名詞	戸畑区
とびでる	一段動詞	飛び出る
とぶ	五段動詞	飛ぶ
とぶらう	五段動詞	訪う
とぼす	五段動詞	灯す
とぼす	五段動詞	燈す
とまる	五段動詞	止まる
とまる	五段動詞	泊まる
とまる	五段動詞	留まる
とむ	五段動詞	富む
とむらう	五段動詞	弔う
とめる	一段動詞	止める
とめる	一段動詞	泊める
とめる	一段動詞	留める
とも	助詞
ともだち	名詞	友達
ともなう	五段動詞	伴う
とやま	名詞	富山
とやま	名詞	富山県
とよひらく	名詞	豊平区
とらえる	一段動詞	捕える
とらす	五段動詞	取らす
とらわれる	一段動詞	囚われる
とり	名詞	鳥
とりつく	五段動詞	取付く
とる	五段動詞	取る
とれる	一段動詞	取れる
とろかす	五段動詞	蕩かす
とろける	一段動詞	鎔ける
とんだ	連体詞
どいつ
どうか	副詞
どうし	名詞	動詞
どうして	副詞
どうぞ	副詞
どこ	名詞	何処	3
どっち
どなる	五段動詞	怒鳴る
どの	連体詞
どのかた	名詞	どの方
どのひと	名詞	どの人
どよむ	五段動詞	響む
どよめく	五段動詞	響動めく
どれ
な	助動詞
な	助詞
なあ	助詞
ない	助動詞
ない	形容詞	亡い	3
ない	形容詞	無い	1
なう	五段動詞	綯う
なえる	一段動詞	萎える
なおす	五段動詞	直す
なおる	五段動詞	直る
なかがわく	名詞	中川区
なかぎょうく	名詞	中京区
なかく	名詞	中区
なかす	五段動詞	泣かす
なかっ	助動詞
なかのく	名詞	中野区
なかはらく	名詞	中原区
なかま	名詞	仲間
なかむらく	名詞	中村区
なかろ	助動詞
ながい	形容詞	永い	1
ながい	形容詞	長い
ながさき	名詞	長崎
ながさき	名詞	長崎県
ながす	五段動詞	流す
ながたく	名詞	長田区
ながの	名詞	長野
ながの	名詞	長野県
ながめる	一段動詞	眺める
ながめる	一段動詞	詠める
ながらう	五段動詞	永らう
ながらう	五段動詞	長らう
ながらえる	一段動詞	永らえる
ながらえる	一段動詞	長らえる
ながれる	一段動詞	流れる
なく	五段動詞	泣く
なく	五段動詞	鳴く
なく	助動詞
なくす	五段動詞	無くす
なぐ	五段動詞	凪ぐ
なぐさむ	五段動詞	慰む
なぐさめる	一段動詞	慰める
なぐる	五段動詞	殴る
なけれ	助動詞
なげうつ	五段動詞	投打つ
なげく	五段動詞	嘆く
なげすてる	一段動詞	投捨てる
なげる	一段動詞	投げる
なごや	名詞	名古屋
なごやし	名詞	名古屋市
なさる	五段動詞	なさる
なじる	五段動詞	詰る
なす	五段動詞	作す
なす	五段動詞	成す
なす	五段動詞	為す
なす	五段動詞	生す
なずむ	五段動詞	泥む
なぜ	副詞
なぜなら	接続詞	何故なら	2
なぞらえる	一段動詞	擬える
なだく	名詞	灘区
なだめる	一段動詞	宥める
なつかしむ	五段動詞	懐かしむ
なつく	五段動詞	懐く
なづける	一段動詞	号ける
なづける	一段動詞	名付ける
なでる	一段動詞	撫でる
など	助詞	等	1
なな	名詞	七
ななつ	名詞	七つ
なにわく	名詞	浪速区
なのる	五段動詞	名乗る
なは	名詞	那覇
なびかす	五段動詞	靡かす
なびく	五段動詞	靡く
なぶる	五段動詞	嬲る
なまめく	五段動詞	艶めく
なまる	五段動詞	訛る
なみいる	一段動詞	並居る
なみだぐむ	五段動詞	涙ぐむ
なみだつ	五段動詞	波立つ
なむ	五段動詞	並む
なめる	一段動詞	嘗める
なめる	一段動詞	舐める
なやます	五段動詞	悩ます
なやむ	五段動詞	悩む
なら	助動詞
なら	名詞	奈良
なら	名詞	奈良県
ならう	五段動詞	倣う
ならう	五段動詞	習う
ならす	五段動詞	均す
ならす	五段動詞	慣らす
ならす	五段動詞	馴らす
ならす	五段動詞	鳴らす
ならびに	接続詞	並びに
ならぶ	五段動詞	並ぶ
ならべる	一段動詞	並べる
ならわす	五段動詞	習わす
なり	助詞
なりあがる	五段動詞	成上がる
なる	五段動詞	成る
なる	五段動詞	為る
なる	五段動詞	生る
なる	五段動詞	鳴る
なれる	一段動詞	慣れる
なれる	一段動詞	馴れる
に	助詞
に	名詞	二
にあう	五段動詞	似合う
にいがた	名詞	新潟
にいがた	名詞	新潟県
にいがたし	名詞	新潟市
にえる	一段動詞	煮える
におう	五段動詞	匂う
におわす	五段動詞	匂わす
にがす	五段動詞	逃がす
にがわらう	五段動詞	苦笑う
にぎる	五段動詞	握る
にぎわう	五段動詞	賑わう
にくむ	五段動詞	憎む
にげさる	五段動詞	逃去る
にげる	一段動詞	逃げる
にこむ	五段動詞	煮込む
にごる	五段動詞	濁る
にしかんく	名詞	西蒲区
にしきょうく	名詞	西京区
にしく	名詞	西区
にしなりく	名詞	西成区
にしよどがわく	名詞	西淀川区
にじる	五段動詞	躙る
にすぎる	一段動詞	煮すぎる
にっぽん	名詞	日本
につめる	一段動詞	煮詰める
になう	五段動詞	担う
になう	五段動詞	荷なう
にほん	名詞	日本
にほんし	名詞	日本史
にほんばしく	名詞	日本橋区
にゃんにゃん	副詞	ニャンニャン
にゅうもん	名詞	入門
にらむ	五段動詞	睨む
にる	一段動詞	似る
にる	一段動詞	煮る
にわか
ぬ	助動詞
ぬう	五段動詞	縫う
ぬかす	五段動詞	吐かす
ぬかる	五段動詞	抜かる
ぬがす	五段動詞	脱がす
ぬきでる	一段動詞	抜出る
ぬく	五段動詞	抜く
ぬく	五段動詞	貫く
ぬぐ	五段動詞	脱ぐ
ぬぐう	五段動詞	拭う
ぬけでる	一段動詞	抜出る
ぬける	一段動詞	抜ける
ぬげる	一段動詞	脱げる
ぬすむ	五段動詞	盗む
ぬらす	五段動詞	濡らす
ぬる	五段動詞	塗る
ぬれる	一段動詞	濡れる
ね	助動詞
ね	助詞
ねえ	助詞
ねえ	感動詞
ねがう	五段動詞	願う
ねぎらう	五段動詞	労う
ねぐ	五段動詞	祈ぐ
ねこ	名詞	猫	1
ねこむ	五段動詞	寝込む
ねざす	五段動詞	根差す
ねじきる	五段動詞	捻切る
ねじる	一段動詞	捻じる
ねじれる	一段動詞	捻れる
ねすぎる	一段動詞	寝過ぎる
ねたむ	五段動詞	妬む
ねたむ	五段動詞	嫉む
ねだる	五段動詞	ねだる
ねぶる	五段動詞	舐る
ねむる	五段動詞	眠る
ねやす	五段動詞	粘す
ねやす	五段動詞	錬す
ねやす	五段動詞	黏す
ねらう	五段動詞	狙う
ねりまく	名詞	練馬区
ねる	一段動詞	寝る
ねる	五段動詞	練る
の	助詞
のうりょく	名詞	能力
のがす	五段動詞	逃す
のがれる	一段動詞	逃れる
のく	五段動詞	退く
のく	五段動詞	除く
のける	一段動詞	退ける
のける	一段動詞	除ける
のこす	五段動詞	残す
のこる	五段動詞	残る
のす	五段動詞	伸す
のす	五段動詞	熨す
のせる	一段動詞	乗せる
のせる	一段動詞	載せる
のぞく	五段動詞	臨く
のぞく	五段動詞	覗く
のぞく	五段動詞	除く
のぞむ	五段動詞	望む
のぞむ	五段動詞	臨む
のたまう	五段動詞	宣う
のっとる	五段動詞	則る
ので	助詞
のに	助詞
ののしる	五段動詞	罵る
のばす	五段動詞	伸ばす
のばす	五段動詞	延ばす
のびる	一段動詞	伸びる
のびる	一段動詞	延びる
のべる	一段動詞	伸べる
のべる	一段動詞	延べる
のべる	一段動詞	述べる
のぼせる	一段動詞	上せる
のぼる	五段動詞	上る
のぼる	五段動詞	昇る
のぼる	五段動詞	登る
のむ	五段動詞	呑む
のむ	五段動詞	飲む
のる	五段動詞	乗る
のる	五段動詞	告る
のる	五段動詞	宣る
のろう	五段動詞	呪う
は	助詞
はい	感動詞
はいする	一段動詞	拝する
はいする	一段動詞	配する
はいる	五段動詞	入る
はう	五段動詞	這う
はえる	一段動詞	映える
はえる	一段動詞	生える
はかたく	名詞	博多区
はかなむ	五段動詞	果無む
はからう	五段動詞	計らう
はかる	五段動詞	計る
はかる	五段動詞	謀る
はがす	五段動詞	剥がす
はがれる	一段動詞	剥がれる
はぎとる	五段動詞	剥取る
はく	五段動詞	佩く
はく	五段動詞	吐く
はく	五段動詞	履く
はく	五段動詞	掃く
はぐ	五段動詞	剥ぐ
はぐ	五段動詞	矧ぐ
はぐくむ	五段動詞	育む
はげます	五段動詞	励ます
はげむ	五段動詞	励む
はげる	一段動詞	矧げる
はげる	一段動詞	禿げる
はこぶ	五段動詞	運ぶ
はさまる	五段動詞	挟まる
はさむ	五段動詞	挟む
はしゃぐ	五段動詞	はしゃぐ
はしる	五段動詞	走る
はじく	五段動詞	弾く
はじまる	五段動詞	始まる
はじめ	名詞	初め
はじめ	名詞	始め
はじめる	一段動詞	始める
はじる	一段動詞	恥じる
はずす	五段動詞	外す
はずむ	五段動詞	弾む
はずれる	一段動詞	外れる
はせる	一段動詞	馳せる
はたす	五段動詞	果たす
はたらかす	五段動詞	働かす
はたらく	五段動詞	働く
はち	名詞	八
はっする	サ変動詞	発する
はっぱ	名詞	葉っぱ
はつる	五段動詞	削る
はてる	一段動詞	果てる
はな	名詞	花
はな	名詞	華	1
はな	名詞	鼻
はなす	五段動詞	放す
はなす	五段動詞	話す
はなつ	五段動詞	放つ
はなみがわく	名詞	花見川区
はなれる	一段動詞	離れる
はねる	一段動詞	刎ねる
はねる	一段動詞	跳ねる
はばかる	五段動詞	憚る
はばむ	五段動詞	阻む
はびこる	五段動詞	蔓延る
はぶく	五段動詞	省く
はぶる	五段動詞	葬る
はべる	五段動詞	侍る
はまきたく	名詞	浜北区
はままつし	名詞	浜松市
はまる	五段動詞	嵌る
はみでる	一段動詞	はみ出る
はむ	五段動詞	蝕む
はむ	五段動詞	食む
はめる	一段動詞	嵌める
はやい	形容詞	早い
はやい	形容詞	速い
はやおき	名詞	早起き
はやしだく	名詞	林田区
はやす	五段動詞	囃す
はやす	五段動詞	映やす
はやす	五段動詞	生やす
はやまる	五段動詞	早まる
はやめる	一段動詞	早める
はやる	五段動詞	早る
はやる	五段動詞	流行る
はやる	五段動詞	逸る
はらう	五段動詞	払う
はらす	五段動詞	晴らす
はらす	五段動詞	腫らす
はらむ	五段動詞	孕む
はる	五段動詞	張る
はる	五段動詞	貼る
はれる	一段動詞	晴れる
はれる	一段動詞	腫れる
はわす	五段動詞	這わす
はんじる	一段動詞	判じる
ば	助詞
ばう	五段動詞	奪う
ばかす	五段動詞	化かす
ばかり	助詞
ばける	一段動詞	化ける
ばらす	五段動詞	ばらす
ばれる	一段動詞	ばれる
ひ	名詞	日
ひ	名詞	火
ひ	名詞	灯	1
ひいでる	一段動詞	秀でる
ひえる	一段動詞	冷える
ひかえる	一段動詞	控える
ひかる	五段動詞	光る
ひがしく	名詞	東区
ひがしすみよしく	名詞	東住吉区
ひがしなだく	名詞	東灘区
ひがしなりく	名詞	東成区
ひがしやまく	名詞	東山区
ひがしよどがわく	名詞	東淀川区
ひがむ	五段動詞	僻む
ひきいる	一段動詞	率いる
ひきさく	五段動詞	引裂く
ひく	五段動詞	引く
ひく	五段動詞	弾く
ひく	五段動詞	挽く
ひく	五段動詞	曳く
ひく	五段動詞	退く
ひける	一段動詞	引ける
ひさぐ	五段動詞	売ぐ
ひさぐ	五段動詞	販ぐ
ひざまずく	五段動詞	ひざまずく
ひしぐ	五段動詞	拉ぐ
ひしめく	五段動詞	犇めく
ひする	一段動詞	秘する
ひそまる	五段動詞	潜まる
ひそめる	一段動詞	潜める
ひたす	五段動詞	浸す
ひたる	五段動詞	浸る
ひっぱる	五段動詞	引張る
ひつじ	名詞	羊	1
ひとつ	名詞	一つ
ひねる	一段動詞	陣る
ひねる	五段動詞	捻る
ひねる	五段動詞	撚る
ひびかす	五段動詞	響かす
ひびく	五段動詞	響く
ひゃく	名詞	百
ひやす	五段動詞	冷やす
ひょうご	名詞	兵庫県
ひょうごく	名詞	兵庫区
ひょうする	一段動詞	評する
ひらがな
ひらく	五段動詞	開く
ひらける	一段動詞	開ける
ひらのく	名詞	平野区
ひらむ	五段動詞	平む
ひらめかす	五段動詞	閃かす
ひらめく	五段動詞	閃く
ひる	一段動詞	乾る
ひる	一段動詞	干る
ひる	五段動詞	放る
ひるがえす	五段動詞	翻す
ひるがえる	五段動詞	翻る
ひるむ	五段動詞	怯む
ひれふす	五段動詞	平伏す
ひろい	形容詞	広い
ひろう	五段動詞	拾う
ひろがる	五段動詞	広がる
ひろげる	一段動詞	広げる
ひろしま	名詞	広島
ひろしま	名詞	広島県
ひろしまし	名詞	広島市
ひろまる	五段動詞	広まる
ひろまる	五段動詞	弘まる
ひろめる	一段動詞	広める
ひろめる	一段動詞	弘める
ひんしつ	名詞	品質
びじゅつ	名詞	びじゅつ
ふえる	一段動詞	増える
ふかがわく	名詞	深川区
ふかす	五段動詞	更かす
ふかまる	五段動詞	深まる
ふかめる	一段動詞	深める
ふきあいく	名詞	葺合区
ふく	五段動詞	吹く
ふく	五段動詞	拭く
ふく	五段動詞	茸く
ふくい	名詞	福井
ふくい	名詞	福井県
ふくおか	名詞	福岡
ふくおか	名詞	福岡県
ふくおかし	名詞	福岡市
ふくしま	名詞	福島
ふくしま	名詞	福島県
ふくしまく	名詞	福島区
ふくする	一段動詞	復する
ふくまる	五段動詞	含まる
ふくむ	五段動詞	含む
ふくめる	一段動詞	含める
ふくらす	五段動詞	膨らす
ふくれる	一段動詞	膨れる
ふける	一段動詞	更ける
ふける	五段動詞	耽る
ふさがる	五段動詞	塞がる
ふさぐ	五段動詞	塞ぐ
ふしみく	名詞	伏見区
ふす	五段動詞	伏す
ふす	五段動詞	臥す
ふせぐ	五段動詞	防ぐ
ふせる	一段動詞	伏せる
ふせる	一段動詞	臥せる
ふた	名詞	二
ふたご	名詞	双子
ふたつ	名詞	二つ
ふとる	五段動詞	太る
ふね	名詞	舟
ふね	名詞	船
ふみにじる	五段動詞	踏躙る
ふむ	五段動詞	踏む
ふやける	一段動詞	ふやける
ふやす	五段動詞	増やす
ふらす	五段動詞	振らす
ふりる	一段動詞	古りる
ふりる	一段動詞	旧りる
ふる	五段動詞	振る
ふる	五段動詞	降る
ふるう	五段動詞	奮う
ふるう	五段動詞	振るう
ふるう	五段動詞	震う
ふるえる	一段動詞	震える
ふるす	五段動詞	古す
ふるす	五段動詞	旧す
ふるまう	五段動詞	振舞う
ふるわす	五段動詞	震わす
ふれる	一段動詞	振れる
ふれる	一段動詞	触れる
ふんばる	五段動詞	踏張る
ぶつ	五段動詞	打つ
ぶつ	五段動詞	撃つ
ぶつかる	五段動詞	ぶつかる
ぶつける	一段動詞	ぶつける
ぶつり	名詞	物理
ぶんがく	名詞	文学
ぶんきょうく	名詞	文京区
ぶんすう	名詞	分数
へ	助詞
へぐ	五段動詞	剥ぐ
へぐ	五段動詞	折ぐ
へす	五段動詞	圧す
へだたる	五段動詞	隔たる
へだてる	一段動詞	隔てる
へつらう	五段動詞	諂う
へる	一段動詞	経る
へる	五段動詞	減る
へんじる	一段動詞	変じる
べっする	一段動詞	別する
ほうける	一段動詞	惚ける
ほうける	一段動詞	耄ける
ほうじる	一段動詞	報じる
ほうむる	五段動詞	葬る
ほうりつ	名詞	法律
ほうる	五段動詞	放る
ほえる	一段動詞	吠える
ほおかぶる	五段動詞	頬被る
ほけん	名詞	保健
ほけん	名詞	保険
ほけんじょ	名詞	保健所
ほこる	五段動詞	誇る
ほころびる	一段動詞	綻びる
ほころぶ	五段動詞	綻ぶ
ほす	五段動詞	乾す
ほす	五段動詞	干す
ほだす	五段動詞	絆す
ほっかいどう	名詞	北海道
ほっする	一段動詞	欲する
ほつれる	一段動詞	解れる
ほてる	五段動詞	火照る
ほとばしる	五段動詞	迸る
ほど	助詞
ほどがやく	名詞	保土ヶ谷区
ほどく	五段動詞	解く
ほどける	一段動詞	解ける
ほどこす	五段動詞	施す
ほのめかす	五段動詞	仄めかす
ほのめく	五段動詞	仄く
ほふる	五段動詞	屠る
ほほえむ	五段動詞	微笑む
ほめる	一段動詞	褒める
ほめる	一段動詞	誉める
ほる	五段動詞	掘る
ほれる	一段動詞	惚れる
ほれる	一段動詞	耄れる
ほろびる	一段動詞	滅びる
ほろぶ	五段動詞	滅ぶ
ほろぼす	五段動詞	滅ぼす
ほんごうく	名詞	本郷区
ほんじょく	名詞	本所区
ほーる	名詞	ホール
ぼく	名詞	僕
ぼける	一段動詞	惚ける
ぼける	一段動詞	耄ける
まあ	感動詞
まい	助動詞
まいらせる	一段動詞	参らせる
まいる	五段動詞	参る
まう	五段動詞	舞う
まえばし	名詞	前橋
まかす	五段動詞	負かす
まかせる	一段動詞	任せる
まかなう	五段動詞	賄う
まかる	五段動詞	罷る
まがう	五段動詞	紛う
まがる	五段動詞	曲がる
まぎらす	五段動詞	紛らす
まぎれる	一段動詞	紛れる
まく	五段動詞	巻く
まく	五段動詞	捲く
まく	五段動詞	播く
まく	五段動詞	蒔く
まける	一段動詞	負ける
まげる	一段動詞	曲げる
まさか	副詞
まさぐる	五段動詞	弄る
まさる	五段動詞	勝る
まさる	五段動詞	増さる
まざる	五段動詞	混ざる
まし	助動詞
ましょ	助動詞
ましょう	助動詞
まじえる	一段動詞	交える
まじなう	五段動詞	呪う
まじる	五段動詞	混じる
まじろぐ	五段動詞	瞬ぐ
まじわる	五段動詞	交わる
ます	五段動詞	増す
ます	助動詞
ますれ	助動詞
ませ	助動詞
まぜる	一段動詞	交ぜる
また	接続詞	又	2
またがる	五段動詞	跨る
またぐ	五段動詞	跨ぐ
またたく	五段動詞	瞬く
まち	名詞	町
まち	名詞	街
まったく	副詞	全く
まつ	五段動詞	待つ
まつえ	名詞	松江
まつやま	名詞	松山
まつる	五段動詞	奉る
まつる	五段動詞	祀る
まつる	五段動詞	祭る
まつろう	五段動詞	服ろう
まつろう	五段動詞	順ろう
まつわる	五段動詞	纏わる
まで	助詞
まとう	五段動詞	纏う
まとまる	五段動詞	纏まる
まとめる	一段動詞	纏める
まどう	五段動詞	惑う
まどろむ	五段動詞	目睡む
まどわす	五段動詞	惑わす
まなぶ	五段動詞	学ぶ
まにあう	五段動詞	間に合う
まぬかれる	一段動詞	免れる
まねく	五段動詞	招く
まねる	一段動詞	真似る
まみえる	一段動詞	見える
まみれる	一段動詞	塗れる
まもる	五段動詞	守る
まよう	五段動詞	迷う
まるで	副詞
まるまる	五段動詞	丸まる
まるめる	一段動詞	丸める
まろぶ	五段動詞	転ぶ
まろむ	五段動詞	丸む
まろむ	五段動詞	円む
まわす	五段動詞	回す
まわり	名詞	周り
まわり	名詞	回り
まわる	五段動詞	回る
まわる	五段動詞	廻る
まん	名詞	万
みあきる	一段動詞	見飽きる
みあげる	一段動詞	見上げる
みあわせる	一段動詞	見合わせる
みえ	名詞	三重県
みえる	一段動詞	見える
みおくる	五段動詞	見送る
みおろす	五段動詞	見下ろす
みかえる	五段動詞	見返る
みかぎる	五段動詞	見限る
みかける	一段動詞	見掛ける
みかわす	五段動詞	見交わす
みがく	五段動詞	磨く
みしる	五段動詞	見知る
みすてる	一段動詞	見捨てる
みず	名詞	水
みずたまり	名詞	水たまり
みずほく	名詞	瑞穂区
みせる	一段動詞	見せる
みそめる	一段動詞	見初める
みたす	五段動詞	満たす
みだす	五段動詞	乱す
みだる	五段動詞	乱る
みだれる	一段動詞	乱れる
みちびく	五段動詞	導く
みちる	一段動詞	満ちる
みっつ	名詞	三つ
みつ	五段動詞	満つ
みつかる	五段動詞	見付かる
みつける	一段動詞	見付ける
みつご	名詞	三つ子
みと	名詞	水戸
みとがめる	一段動詞	見咎める
みとめる	一段動詞	認める
みどりく	名詞	緑区
みなぎる	五段動詞	漲る
みなす	五段動詞	見倣す
みなとく	名詞	港区
みなとく	名詞	湊区
みなみく	名詞	南区
みなれる	一段動詞	見慣れる
みぬく	五段動詞	見抜く
みぬまく	名詞	見沼区
みのる	五段動詞	実る
みはまく	名詞	美浜区
みはらく	名詞	美原区
みはる	五段動詞	見張る
みばえ	名詞	見栄え
みまわす	五段動詞	見回す
みやぎ	名詞	宮城県
みやぎのく	名詞	宮城野区
みやこじまく	名詞	都島区
みやざき	名詞	宮崎
みやざき	名詞	宮崎県
みやまえく	名詞	宮前区
みる	一段動詞	見る
みわける	一段動詞	見分ける
みわたす	五段動詞	見渡す
むかう	五段動詞	向かう
むかえる	一段動詞	迎える
むく	五段動詞	剥く
むく	五段動詞	向く
むくいる	一段動詞	報いる
むくう	五段動詞	報う
むける	一段動詞	剥ける
むける	一段動詞	向ける
むこうじまく	名詞	向島区
むさぼる	五段動詞	貪る
むしる	五段動詞	毟る
むしろ	接続詞	寧ろ	3
むす	五段動詞	生す
むす	五段動詞	蒸す
むすぶ	五段動詞	結ぶ
むせぶ	五段動詞	咽ぶ
むせる	一段動詞	咽せる
むちうつ	五段動詞	鞭打つ
むっつ	名詞	六つ
むつかる	五段動詞	憤る
むつぶ	五段動詞	睦ぶ
むらがる	五段動詞	群がる
むれる	一段動詞	群れる
め	名詞	目
めあわす	一段動詞	妻合わす
めあわせる	一段動詞	妻合わせる
めいとうく	名詞	名東区
めがける	一段動詞	目掛ける
めくるめく	五段動詞	目眩く
めぐむ	五段動詞	恵む
めぐらす	五段動詞	巡らす
めぐる	五段動詞	巡る
めぐろく	名詞	目黒区
めざす	五段動詞	目指す
めざめる	一段動詞	目覚める
めしつかう	五段動詞	召使う
めしとる	五段動詞	召捕る
めす	五段動詞	召す
めっする	一段動詞	滅する
めでる	一段動詞	愛でる
めとる	五段動詞	娶る
めもりー	名詞	メモリー
めんじる	一段動詞	免じる
も	助詞
もうかる	五段動詞	儲かる
もうける	一段動詞	儲ける
もうける	一段動詞	設ける
もうす	五段動詞	申す
もうでる	一段動詞	詣でる
もえる	一段動詞	燃える
もえる	一段動詞	萌える
もがく	五段動詞	もがく
もぐ	五段動詞	もぐ
もぐる	五段動詞	潜る
もげる	一段動詞	もげる
もし	副詞	若し	3
もし	感動詞
もしもし	感動詞
もじく	名詞	門司区
もじる	五段動詞	屯る
もたげる	一段動詞	抬げる
もたれる	一段動詞	凭れる
もだえる	一段動詞	悶える
もちいる	一段動詞	用いる
もちろん	副詞	勿論	3
もっと	副詞
もつ	五段動詞	持つ
もつれる	一段動詞	縺れる
もてあそぶ	五段動詞	玩ぶ
もてなす	五段動詞	持成す
もてる	一段動詞	持てる
もと	名詞	下
もと	名詞	元
もと	名詞	基
もと	名詞	本	1
もとづく	五段動詞	基づく
もとまる	五段動詞	求まる
もとめる	一段動詞	求める
もどす	五段動詞	戻す
もどる	五段動詞	戻る
もの
ものいう	五段動詞	物言う
ものおもう	五段動詞	物思う
ものの	助詞
ものもうす	五段動詞	物申す
もむ	五段動詞	揉む
もやす	五段動詞	燃やす
もよおす	五段動詞	催す
もらう	五段動詞	貰う
もらす	五段動詞	洩らす
もらす	五段動詞	漏らす
もりおか	名詞	盛岡
もりやまく	名詞	守山区
もる	五段動詞	守る
もる	五段動詞	洩る
もる	五段動詞	漏る
もる	五段動詞	盛る
もれる	一段動詞	洩れる
もれる	一段動詞	漏れる
や	助詞
やあ	感動詞
やおや	名詞	八百屋
やぎ	名詞	山羊	2
やく	五段動詞	焼く
やくす	五段動詞	訳す
やくする	一段動詞	約する
やける	一段動詞	焼ける
やしなう	五段動詞	養う
やすまる	五段動詞	休まる
やすむ	五段動詞	休む
やすめる	一段動詞	休める
やすらう	五段動詞	休らう
やせる	一段動詞	痩せる
やっつ	名詞	八つ
やつす	五段動詞	窶す
やつれる	一段動詞	窶れる
やとう	五段動詞	雇う
やどる	五段動詞	宿る
やね	名詞	屋根
やはたく	名詞	八幡区
やはたにしく	名詞	八幡西区
やはたひがしく	名詞	八幡東区
やぶる	五段動詞	破る
やぶれる	一段動詞	敗れる
やぶれる	一段動詞	破れる
やま	名詞	山
やまがた	名詞	山形
やまがた	名詞	山形県
やまぐち	名詞	山口
やまぐち	名詞	山口県
やましなく	名詞	山科区
やまなし	名詞	山梨県
やむ	五段動詞	止む
やむ	五段動詞	病む
やめる	一段動詞	止める
やら	助詞
やる	五段動詞	遣る
やわらかい	形容詞	柔らかい	1
やわらかだ	形容動詞	柔らかだ	1
やわらぐ	五段動詞	和らぐ
やわらぐ	五段動詞	柔らぐ
やわらげる	一段動詞	和らげる
やわらげる	一段動詞	柔らげる
ゆ	名詞	湯
ゆいつける	一段動詞	結付ける
ゆう	五段動詞	結う
ゆえに	接続詞	故に	2
ゆがむ	五段動詞	歪む
ゆく	五段動詞	行く
ゆすぐ	五段動詞	濯ぐ
ゆする	五段動詞	揺する
ゆずる	五段動詞	譲る
ゆたかだ	形容動詞	豊かだ
ゆだねる	一段動詞	委ねる
ゆだる	五段動詞	茹だる
ゆでる	一段動詞	茹でる
ゆびく	五段動詞	湯引く
ゆびさす	五段動詞	指差す
ゆらえる	一段動詞	揺らえる
ゆらぐ	五段動詞	揺らぐ
ゆる	五段動詞	汰る
ゆる	五段動詞	淘る
ゆるぐ	五段動詞	揺るぐ
ゆるす	五段動詞	許す
ゆるす	五段動詞	赦す
ゆるむ	五段動詞	弛む
ゆるむ	五段動詞	緩む
ゆるめる	一段動詞	緩める
ゆれる	一段動詞	揺れる
ゆわえる	一段動詞	結わえる
よ	助詞
よう	五段動詞	酔う
よう	助動詞
ようこそ	感動詞
ようだ	助動詞	様だ	1
ようだっ	助動詞	様だっ	1
ようだろ	助動詞	様だろ	1
ようで	助動詞	様で	1
ような	助動詞	様な	1
ようなら	助動詞	様なら	1
ように	助動詞	様に	1
よぎる	五段動詞	過ぎる
よける	一段動詞	避ける
よこたえる	一段動詞	横たえる
よこたわる	五段動詞	横たわる
よこはま	名詞	横浜
よこはまし	名詞	横浜市
よごす	五段動詞	汚す
よごれる	一段動詞	汚れる
よしんば	副詞
よじる	一段動詞	攀じる
よす	五段動詞	寄す
よせる	一段動詞	寄せる
よそう	五段動詞	装う
よそえる	一段動詞	装える
よだつ	五段動詞	弥立つ
よっつ	名詞	四つ
よつやく	名詞	四谷区
よどがわく	名詞	淀川区
よどばしく	名詞	淀橋区
よどむ	五段動詞	淀む
よどむ	五段動詞	澱む
よばわる	五段動詞	呼ばわる
よぶ	五段動詞	呼ぶ
よむ	五段動詞	詠む
よむ	五段動詞	読む
よもや	副詞
より	助詞
よりあう	五段動詞	寄合う
よりつく	五段動詞	寄付く
よる	五段動詞	依る
よる	五段動詞	寄る
よる	五段動詞	拠る
よる	五段動詞	縒る
よれる	一段動詞	縒れる
よろう	五段動詞	鎧う
よろこぶ	五段動詞	喜ぶ
よろつく	五段動詞	よろつく
よわす	五段動詞	酔わす
よわる	五段動詞	弱る
よん	名詞	四
らいきゃく	名詞	来客
らいする	一段動詞	礼する
らしい	助動詞
らしかっ	助動詞
らしく	助動詞
らしけれ	助動詞
られ	助動詞
られよ	助動詞
られる	助動詞
られれ	助動詞
られろ	助動詞
りか	名詞	理科
りきむ	五段動詞	力む
りする	一段動詞	利する
りょうじる	一段動詞	寮じる
りょうり	名詞	料理
りよう	名詞	利用
れ	助動詞
れきし	名詞	歴史
れよ	助動詞
れる	助動詞
れれ	助動詞
れろ	助動詞
ろく	名詞	六
ろんじる	一段動詞	論じる
ろんずる	サ変動詞	論ずる
わ	助詞
わかす	五段動詞	沸かす
わかつ	五段動詞	分かつ
わかばく	名詞	若葉区
わかばやしく	名詞	若林区
わかまつく	名詞	若松区
わかやま	名詞	和歌山
わかやま	名詞	和歌山県
わかる	五段動詞	分かる
わかれる	一段動詞	分かれる
わかれる	一段動詞	別れる
わが	連体詞	我が
わがねる	一段動詞	綰ねる
わきだす	五段動詞	湧出す
わきでる	一段動詞	湧き出る
わきばさむ	五段動詞	脇挟む
わきまえる	一段動詞	弁える
わく	五段動詞	分く
わく	五段動詞	別く
わく	五段動詞	沸く
わく	五段動詞	湧く
わける	一段動詞	分ける
わける	一段動詞	別ける
わざ	名詞	技
わざ	名詞	業	2
わする	一段動詞	和する
わすれる	一段動詞	忘れる
わずらう	五段動詞	煩う
わたくし	名詞	私
わたし	名詞	私
わたす	五段動詞	渡す
わたらす	五段動詞	渡らす
わたる	五段動詞	渡る
わだかまる	五段動詞	蟠る
わななく	五段動詞	戦慄く
わね	助詞
わびる	一段動詞	侘びる
わびる	一段動詞	詫びる
わめく	五段動詞	喚く
わらう	五段動詞	笑う
わる	五段動詞	割る
わるびれる	一段動詞	悪怯れる
われる	一段動詞	割れる
わんわん	副詞	ワンワン
を	助詞
ん	助動詞
カタカナ
キャッチ
ドイツ
ヒツジ
ヤギ
